8 16 30
1111111111111111
1      11    111
1 1111 11 11#111
1^11 1 11 11#111
1 #  1111 11    
1 11 11   11^111
  11      #    1
1111111111111111