
1111111111111111
1      11    111
1 1111 11 11#111
1^11 1 11 11#111
1XXXX1111 11XXXX
1X11X11   11X111
XX11XXXXXXXXX  1
1111111111111111
